W,W,W,W,W,W,W,W,W,W,W,W,W,W,W,W,W,W,W,W,W,W
W,B,B,B,B,B,B,B,B,B,B,B,B,B,B,B,B,B,B,B,B,W
W,B,B,B,B,B,B,B,B,B,B,B,B,B,B,B,B,B,B,B,B,W
W,B,B,B,B,B,B,B,B,B,B,B,B,B,B,B,B,B,B,B,B,B
W,B,B,B,B,B,B,B,B,B,B,B,B,B,B,B,B,B,B,B,B,E
W,B,B,B,B,B,B,B,B,B,B,B,B,B,B,B,B,B,B,B,B,B
W,B,B,B,B,B,B,B,B,B,B,B,B,B,B,B,B,F,F,F,F,F
W,B,B,B,B,B,B,B,B,B,B,B,B,B,B,B,B,W,W,W,W,W
W,B,B,B,B,B,B,B,B,B,B,B,B,B,B,B,B,W,W,W,W,W
W,B,B,B,B,B,B,B,B,B,B,B,B,B,B,B,B,W,W,W,W,W
W,B,B,B,B,B,B,B,B,B,B,B,B,B,B,B,B,W,W,W,W,W
W,B,B,B,B,B,B,B,B,B,B,B,B,B,B,B,B,W,W,W,W,W
W,B,B,B,B,B,B,B,B,B,B,B,B,B,B,B,B,W,W,W,W,W
W,B,B,B,B,B,B,B,F,F,B,B,B,B,B,B,B,W,W,W,W,W
W,B,B,B,B,B,B,B,W,W,B,B,L,C,R,B,B,W,W,W,W,W
W,B,B,B,B,B,B,B,W,W,B,B,B,B,B,B,B,W,W,W,W,W
W,B,B,B,B,F,F,F,W,W,B,B,B,B,B,B,B,W,W,W,W,W
W,B,B,B,B,W,W,W,W,W,B,B,B,B,B,B,B,W,W,W,W,W
W,B,B,B,B,W,W,W,W,W,B,B,B,B,B,B,B,W,W,W,W,W
W,B,S,B,B,W,W,W,W,W,B,B,B,B,B,B,B,W,W,W,W,W
W,B,B,B,B,W,W,W,W,W,B,B,B,B,B,B,B,W,W,W,W,W
W,F,F,F,F,W,W,W,W,W,F,F,F,F,F,F,F,W,W,W,W,W